xx================================================================
x                =                                               =
= ============ === ========================================== ====
=                = =           =                                 =
=========== ====== == ======== =================== ============= =
=   =  =  = =  =    = =        =   =    =       =  ===============
=   =  == = =  =    = =        =   =    =       =      =   =     =
= ===     = =  =    = =======  ===    =======   ====== =   =     =
=   =  =  = =  =    =       =  =     ===    =   =    = =      == =
=      =  = =  =    = =  ====  =     ==  =  =   =  =          =  =
= ======  = =  =    = =     =  =   ====  =  =   =  ============  =
= ==        =  =      ===   =  = ====    =                       =
=  ==  =  = =       = =     =  = ==   =======================  ===
=   =  =  = ========= =   ===  = =  =  = =      =                =
= ====== == =         =     =  = =  =  = = ==         === ====== =
=         = =  ==========   =  = =  =  = = =   =  =   =   =  = = =
========= = =         =     =    =  =  =   = =    = = =      =   =
=   =   = ==========  =  =======================  =   =   ==== =====
= =   =               =             =                  =  =       &=
====================================================================
------------------------------------------------------------------
-                                                                -
------------------------------------------------------------------
